1111111111111
1011000000001
1000011111001
1P0010E000001
1111111111111