1111111111111111111111
11C0000000000001100001
1111001111000100000001
10P100001C000100010001
1011001111111100111001
1C00011000C11100110001
10000000111E000011C001
1111111111111111111111