1111111111111
10C1000001E01
1000000100001
1001C01110001
1P0000000C001
1111111111111