1111111111111111
1000000000C00001
1000000011111101
111100000011C001
1000000011111101
1C11100000P00001
1000110001111111
1E00000001111111
1111111111111111